1111111111111111111111111111111111
1000P00000000000C00000000000000001
1000110011111001111100011111000C01
10010100000010000C010000001100C001
100C0100111110011111000001100000C1
1000010000001000C0010000110C000001
10C001001111100111110001100000C001
10C0000C00000000000000C0000000C001
10000C0000000000C000000000000C0E01
1111111111111111111111111111111111