11111111111111111111
1P010000000000000001
10010000000000000001
1C010000000001111111
11010X00000001000001
10000000000001E00001
11111111111111111111