1111111111111111111111111111111111
1P0001000000000C00000C00010000C001
1000C1000001000C00000C000100C00001
10C00000000100C00000C0000000C00E01
1111111111111111111111111111111111